amino_acid	templates
FDNLVDFEYEFYNRLPV	9
EHYREGVQNCC	1
RNWLHKFWRAWS	3
YILFCGWSAVNCGCIPH	8
ADAPHTFDRI	6
HGMDCYMWEECRCKNCYAM	6
AYCFAMTDPPTEL	1
LPVPLCGRSWG	7
WSIPHEFICIRTIQLNEDQ	3
NCAEKVKGMVCGN	3
NFLKFWQGQLKGGFGFSID	1
LREKWIGSHHTKQWFFHLP	8
NAFFFWKSEWIQLT	8
GDPFCGTEAIKV	7
PFFEFQEDFQAKI	1
CEGCEKEEDHS	2
HCCYSPGNGHSATDFMRW	4
HERRTVMVGEWEQFGWLM	8
PVVEEAPITYYCECDLD	5
LFMVYPMFHGLAPVGTMY	4
ACTYCQFDIC	2