amino_acid	templates
RNTANPCKHEQMWM	5
NREHEFTTEWMILSMFPRG	5
SVQWMVMVMC	9
CMDELDALVAGVER	7
DWNRTKSIVWKPEQ	7
NDDIDSTTQE	1
LTMMRAQIPQC	7
GWSEINCKFPMARNKLW	1
DMKLAGFMDCLRA	9
AQTEHNQTRVFGCDCCFFD	7
GERMKYMTSIKAPGT	8
MLDIPNWNPYNIMPFC	5
KDPCNFHIEYMA	1
DFWRRGYQWCSGMTFQIMN	4
AEPVAWQVST	7
SCNCMENMIGRMGSESAS	8
QEKFGQVVQSRNVFTW	3
NPSMRNYEGEKRRK	3
FLWTQWIDWLIWIFSNIC	8
KSCQQGVMMMVMKRAYV	6