amino_acid	templates
LNQMGAWWKGYDWRVDPQ	3
WQFWCTINCDACARC	1
YKSDQMDLMNFLDKF	9
KYYHHPMMQI	8
IYIKAMWHVVIKMVYHWS	1
WHNGHLIDVNDAIYLD	5
QYQILGQGPSFEHNRHFFF	6
VVYHHQTSHNLF	5
PAAFVTYVPDRHMNGP	8
RCINCNTTPICFAN	1
KRIALCQIWSREAYKGD	1
AQMRYEYKSNCFFNF	3
FLCLRFPVMPME	1
ISECPCANYMFEGQAIHWL	7
IRVPLYPNHND	8
FWSCHNQFSVDD	2
QFPNQLGPLLD	2
QCGEVGEPNMSVEP	8
LCVLWYDYRTI	8
HWTQDLNNETTICKNNES	3
PDQTDQSTPHTCVWNQLMN	5