amino_acid	templates
YHMGRPNGHIM	4
ERIRAQHDYFNPEG	5
HYYCPECFIGAYNF	4
INQSFLVHFVNL	2
PFSWSHGPNRGSDEGQN	1
KGWCLMIALWNCYD	5
NHMNALSQSRICQ	9
CMGRYICMYCITAMA	6
NFEHNMYGIKTHK	6
DYYGCRMHICRKIPSDQY	9
IMHLGRSLYCQTMYY	2
TPNGVYRESWK	8
WQLYWPPWRYDMNKWRM	9
NECDYCRLPMI	1
MDAGFWCTPEGNMPKFF	8
YVYFDVWKFSL	5
YRERETSWDLGAG	4
RQWPFYDRFYEASYNH	4
VRVKMIVEDHGPLYKCVGV	2
DIVCKSFAKCYRH	7
GDTLENPDGI	6