amino_acid	templates
FHMHKFPSTW	5
LNVTFRCNVDDISGDFFCF	4
KYALCYNHSKGQCEKG	6
LLPPGGCPFVLDWY	4
QKVDINRYGDL	4
FWATCVNLMNLDQMVSSRQ	5
PWCQMMSDATALACY	8
TARRPNSTCSALFQ	9
YTKWIQFHMRKFILMDTLA	7
TLAKDASGEAPI	6
IHGMVNEDFQVRDI	8
CGPEFFEYPMIC	7
FYYDYGWKGAISF	5
CPFDCQGNARMPMTG	2
TIYNTVQIMSMNSLE	4
DCVRNEGSRNGTS	1
LMHFNGVYAPGCQAI	7
ILMKSPQGTKNYG	3
KNRDMEAYEQ	5
CTRKHKPIYMTEQNYF	2
FNSMRCRNFK	2