amino_acid	templates
YVHPTPMTCGFL	8
MFFQGDWRPHSEEHHRYT	1
INAAMYPNMWFAAGFTA	4
TNPREYSQLTMQY	8
IFNLMARGKMIQNGKL	9
YAQYIGAFAWQF	7
LFSARQSTASFNKCGW	3
RQETGWGMVPAT	6
PEFHHAEQHNRIFMLNI	6
WLSWFMISMHRA	5
QKSAYMTQETHAHAYWCS	8
NDNWFIYLYHQSNNAK	8
NTENAGCAWGTN	4
MIQWDICNVRRCQSIN	9
GAFPRWVKDRRKDCNG	8
CFPQCNTYNGHQTMAYAPQ	3
PGMHLRWARKEDSPHQPS	4
EVNRFIEPRFKKTIVK	9
CKPRCNPQVPDYTHRAEEE	2