amino_acid	templates
QTLFIGIECLCKTH	9
PHAMPQCALFELKYQ	5
IYPDFQQILISNLCNTN	8
KCPVKADHGMT	2
LNICQPGGTNKGSTIK	9
NTALSPFVEHLTFRQC	9
SCSMVEYRFQP	2
FYGAVVVIKWG	5
EAECRPHFHVCT	2
RMVGKKCGAANY	2
RGTWGEMMLIAARDGE	6
QWVDDYWFNEVDY	1
LREPVMVAVNKDTFLMSV	5
QEVEQYWPRMQQQYCEP	9
YMHNQIQWWSRCQYWITQ	8
NPHVALGHCYKINVKA	5
EQKHMLLFITWRRR	6
ETEMALRCWCYPDM	1
LVRQCMEVAQVIA	3