amino_acid	templates
CLCKYEPFPMWF	5
GPVKPTAEVVN	5
EQNDYCLLYFTC	1
NRCSRRNDFRLCEVCTDC	8
MHGMHLHGKV	6
ESHRHMITYDYIPYYYS	4
YKQHHDMYFHGRWCPPR	2
FLVSFPHDYMYL	3
LNIGQDRAAPYMML	8
VYQWTWCSARLHY	1
HSYMQLFTSRKAQ	5
RFAPPLMQWWV	6
GYSQMAKHGSRCTTS	5
GKTHYIGAYRHK	3
VSMWKYMHRSVL	3
TPSELHASPLRGV	3
ETYWNVVCIKRRWSEPKIC	2
HLNTENVSVVWSWQFWMMN	8
LIAIVMHTFGPTARPCSPA	2
PKVNCKAPWSNTQLI	8
HCNKFSYCMIERS	8